............
.M.........m
AI...si....a
..I..ff.i...
TI.c.Cf...it
.I...ff.i...
AI....s.i..a
...M........
............
............
