............
............
.....s......
...C.ff.....
.....ff..a..
.....ff.....
......s.....
............
............
............
