T...........
.I..........
.....s......
.....ff.....
.....ff.....
.....sf.....
......s.....
............
..........i.
...........t
